哈尔滨师范大学,中国	黑龙江省	哈尔滨市
北京联合大学,中国	北京市
浙江科技学院,中国	浙江省	杭州市
青岛大学,中国	山东省	青岛市
江西财经学院九江分院,中国	江西省	九江市
清华大学,中国	北京市
福州大学老校区子兴楼五楼,中国	福建省	福州市
南京大学,中国	江苏省	南京市
东北大学,中国	辽宁省	沈阳市
北京人民警察学院,中国	北京市
佳木斯大学,中国	黑龙江省	佳木斯市
湖南省岳阳市湖南理工学院,中国	湖南省	岳阳市
华中科技大学紫松公寓,中国	湖北省	武汉市
西安思源学院,中国	陕西省	西安市
重庆信息工程专修学院,中国	重庆市
北京朝阳区(芍药居)经贸大学东门太子网吧,中国	北京市
华中科技大学紫菘公寓,中国	湖北省	武汉市
西安外事学院,中国	陕西省	西安市
陕西省西安市欧亚学院,中国	陕西省	西安市
吉林大学南湖校区,中国	吉林省	长春市
内蒙古农业大学,中国	内蒙古	呼和浩特市
华中农业大学学生宿舍,中国	湖北省	武汉市
北京化工大学,中国	北京市
北方工业大学四教东区机房B区,中国	北京市
中北大学,中国	山西省	太原市
武汉科技大学,中国	湖北省	武汉市
武汉大学工学部,中国	湖北省	武汉市
山东省潍坊学院,中国	山东省	潍坊市
四川大学,中国	四川省	成都市
西安石油大学(南区)综合楼五楼机房,中国	陕西省	西安市
湖南省长沙理工大学,中国	湖南省	长沙市
厦门大学漳州校区,中国	福建省	漳州市
南京理工大学,中国	江苏省	南京市
北京石油化工学院,中国	北京市
北方工业大学,中国	北京市
成都工业学院,中国	四川省	成都市
福建工程学院,中国	福建省	福州市
南开大学,中国	天津市
重庆工学院,中国	重庆市
北京体育大学,中国	北京市
新疆大学软件学院机房B区,中国	新疆	乌鲁木齐市
北方工业大学四教东区机房A区,中国	北京市
中国农业大学东校区,中国	北京市
山东大学,中国	山东省	威海市
南昌大学,中国	江西省	南昌市
中国农业科学院,中国	北京市
广东省广州市华南师范大学大学城校区,中国	广东省	广州市
对外经济贸易大学学生公寓,中国	北京市
西北工业大学,中国	陕西省	西安市
北方工业大学四教东区机房D区,中国	北京市
四川大学中心村,中国	四川省	成都市
成都中医药大学,中国	四川省	乐山市
华南农业大学泰山区,中国	广东省	广州市
南昌理工学院,中国	江西省	南昌市
西安建筑科技大学,中国	陕西省	西安市
成都信息工程学院,中国	四川省	绵阳市
上海大学,中国	上海市
北京市房山区理工大学对面尚学城网吧,中国	北京市
首都经贸大学东区7楼大机房,中国	北京市
湖北大学,中国	湖北省	武汉市
新疆大学软件学院机房A区,中国	新疆	乌鲁木齐市
东华大学,中国	上海市
湖北第二师范学院,中国	湖北省	武汉市
四川西南科技大学,中国	四川省	绵阳市
哈尔滨理工大学,中国	黑龙江省	哈尔滨市
北方工业大学四教东区机房C区,中国	北京市
华南理工大学北区北十一,中国	广东省	广州市
集美大学航海学院,中国	福建省	厦门市
宁夏大学,中国	宁夏	自治区银川市
南京大学鼓楼校区,中国	江苏省	南京市
中南大学岳麓山校区,中国	湖南省	
台湾大学,中国	台湾省	
北方工业大学一教6机房,中国	北京市
武汉大学信息学部,中国	湖北省	武汉市
北方工业大学一教七机房,中国	北京市
上海交通大学闵行校区图书馆本科生阅览室蓝牌,中国	上海市
兰州大学榆中校区,中国	甘肃省	兰州市
四川行政学院,中国	四川省	成都市
中南财经政法大学,中国	湖北省	武汉市
西安交通大学,中国	陕西省	西安市
清华大学学生宿舍,中国	北京市
北方工业大学一教5机房,中国	北京市
黄河科技大学,中国	河南省	郑州市
湖南科技大学,中国	湖南省	湘潭市
武汉大学医学部,中国	湖北省	武汉市
华南理工大学,中国	广东省	广州市
大连理工大学北山B区,中国	辽宁省	大连市
北京化工大学东区学生宿舍楼,中国	北京市
北方工业大学四教东区机房F区,中国	北京市
上海交通大学,中国	上海市
太原科技大学,中国	山西省	太原市
北京信息科技大学,中国	北京市
东北林业大学,中国	黑龙江省	哈尔滨市
江西财经大学,中国	江西省	南昌市
上海交通大学闵行校区图书馆本科生阅览室红牌,中国	上海市
中央财经大学,中国	北京市
浙江大学,中国	浙江省	杭州市
青海大学,中国	青海省	西宁市
江苏省盐城师范学院综合楼603机房,中国	江苏省	盐城市
江苏省南京大学,中国	江苏省	南京市
西安石油大学(本部)计算机中心二楼,中国	陕西省	西安市
华南理工大学北区B2,中国	广东省	广州市
辽宁省大连市东北财经大学,中国	辽宁省	大连市
北方工业大学一教2机房,中国	北京市
中山大学,中国	广东省	广州市
北方工业大学四教东区机房E区,中国	北京市
浙江工业大学,中国	浙江省	杭州市
黑龙江大学,中国	黑龙江省	哈尔滨市
贵州工业大学,中国	贵州省	贵阳市
河北大学,中国	河北省	保定市
北京林业大学,中国	北京市
长春工业大学,中国	吉林省	长春市
兰州大学,中国	甘肃省	兰州市
吉林大学朝阳校区,中国	吉林省	长春市
四川师范大学,中国	四川省	成都市
江西九江学院,中国	江西省	九江市
安徽财经大学,中国	安徽省	合肥市
西安交通大学东,中国	陕西省	西安市
北方工业大学一教3机房,中国	北京市
东南大学,中国	江苏省	南京市
北方工业大学一教4机房,中国	北京市
四川大学竹林村,中国	四川省	成都市
吉林大学前卫南区,中国	吉林省	长春市
江西师范大学,中国	江西省	南昌市
黑龙江东方学院,中国	黑龙江省	哈尔滨市
江苏省盐城师范学院综合楼501机房,中国	江苏省	盐城市
齐齐哈尔医学院,中国	黑龙江省	齐齐哈尔市
上海市同济大学,中国	浙江省	嘉兴市
吉林大学,中国	吉林省	长春市
哈尔滨师范大学阿城学院图书馆2楼电子阅览室,中国	黑龙江省	哈尔滨市
北方工业大学第三教学楼机房D区,中国	北京市
华南农业大学华山区,中国	广东省	广州市
浙江轻纺学院,中国	浙江省	宁波市
长江大学东校区,中国	湖北省	荆州市
长春职业技术学院,中国	吉林省	长春市
江苏省盐城师范学院综合楼703机房,中国	江苏省	盐城市
北方工业大学第三教学楼机房C区,中国	北京市
清华大学紫荆公寓,中国	北京市
华中科技大学韵苑公寓15栋,中国	湖北省	武汉市
吉林大学南区文苑,中国	吉林省	长春市
湖南商学院,中国	湖南省	长沙市
安徽农业大学,中国	安徽省	合肥市
厦门大学嘉庚五408室,中国	福建省	厦门市
西安石油大学,中国	陕西省	西安市
安徽大学,中国	安徽省	合肥市
华南农业大学,中国	广东省	广州市
宁波大学,中国	浙江省	宁波市
中南大学,中国	湖南省	长沙市
华北科技学院,中国	河北省	廊坊市
西华大学,中国	四川省	成都市
北方工业大学第三教学楼机房B区,中国	北京市
上海理工大学,中国	上海市
吉林大学前卫北区,中国	吉林省	长春市
郑州大学,中国	河南省	郑州市
江苏省盐城师范学院,中国	江苏省	盐城市
河北省秦皇岛市燕山大学,中国	河北省	秦皇岛市
山东省济南市山东大学,中国	山东省	济南市
云南大学,中国	云南省	昆明市
中国农业大学西区员工绿苑,中国	北京市
华东理工大学,中国	上海市
湖北省武汉大学,中国	湖北省	武汉市
湖北省荆州市职业技术学院,中国	湖北省	荆州市
青岛科技大学,中国	山东省	青岛市
汉中理工学院,中国	陕西省	汉中市
北京理工大学,中国	北京市
长沙交通学院,中国	湖南省	长沙市
四川农业大学,中国	四川省	成都市
北方工业大学第三教学楼机房A区,中国	北京市
浙江广播电视大学,中国	浙江省	台州市
上海交通大学七宝校区,中国	上海市
湖北省武汉科技大学南校区,中国	湖北省	武汉市
东华理工大学,中国	江西省	抚州市
大连理工大学,中国	辽宁省	大连市
西华大学计算中心2机房,中国	四川省	成都市
上海交通大学上海第二医学院,中国	上海市
厦门大学嘉庚五508室,中国	福建省	厦门市
首都科技大学,中国	北京市
吉林大学南岭校区,中国	吉林省	长春市
湖南师范大学,中国	湖南省	长沙市
首都师范大学,中国	北京市
重庆大学,中国	重庆市
湖南长沙财经学院,中国	湖南省	长沙市
合肥工业大学,中国	安徽省	合肥市
北京科技大学,中国	北京市
北京中医药大学,中国	北京市
首都经贸大学,中国	北京市
四川大学新南村,中国	四川省	成都市
吉林大学新民校区,中国	吉林省	长春市
成都信息工程学院学生公寓,中国	四川省	成都市
上海财经大学,中国	浙江省	金华市
华东师范大学,中国	上海市
北京大学万柳学区,中国	北京市
长江大学,中国	湖北省	荆州市
郑州大学新校区临时图书馆,中国	河南省	郑州市
大连理工大学西山生活区,中国	辽宁省	大连市
哈尔滨工程大学,中国	黑龙江省	哈尔滨市
西安交通大学东区图书馆二楼的树华电子阅览室,中国	陕西省	西安市
东北农业大学,中国	黑龙江省	哈尔滨市
成都大学,中国	四川省	成都市
中国人民大学,中国	北京市
南京化工大学,中国	江苏省	南京市
四川理工学院,中国	四川省	自贡市
北方工业大学第三教学楼机房F区,中国	北京市
西安石油大学(本部)计算机中心二楼(第五微机室),中国	陕西省	西安市
华中科技大学东,中国	湖北省	武汉市
对外经济贸易大学,中国	北京市
四川大学华西校区,中国	四川省	成都市
上海交通大学闵行校区,中国	上海市
上海市电力学院,中国	上海市
长沙理工大学,中国	湖南省	长沙市
长沙电力职业技术学院,中国	湖南省	长沙市
安徽建筑工业学院,中国	安徽省	合肥市
成都理工大学,中国	四川省	成都市
华中科技大学韵苑公寓,中国	湖北省	武汉市
北京科技大学图书馆多功能阅览室,中国	北京市
西安科技大学,中国	陕西省	西安市
南昌工程学院,中国	江西省	南昌市
华中农业大学,中国	湖北省	武汉市
山西省太原市山西工商学院,中国	山西省	太原市
青海建筑职业技术学院,中国	青海省	西宁市
北方工业大学第三教学楼机房E区,中国	北京市
北京化工大学东区学生宿舍,中国	北京市
四川大学川大花园,中国	四川省	成都市
大庆职工大学,中国	吉林省	长春市
北京科技职业学院,中国	北京市
北京工业大学,中国	北京市
北京大学,中国	北京市
湖南农业大学,中国	湖南省	长沙市
西安联合大学,中国	陕西省	西安市
北京信息科技大学(北机部分),中国	北京市
